20 20
####################
#.#.M#...........###
#.#M.#.#########..##
#&#.#..#........#.##
#&#...#..#####..#.##
#:#..#..#..........#
#M...#...###########
########..#.....####
#M.....##.#......###
#..###....#..###...#
#..#.##.#.#..#.#...#
#..#..#.###..#.#...#
#..#..#............#
#..#..##############
#..#..##############
#..#..############.#
#..#...............#
#..##############..#
#..................#
####################